#####################
#.....###....##.....#
#...................#
#.....###....##.....#
##########..#########
         #..#
         #..#
         #..#
         #..#
##########..#########
#.....###....##.....#
#...................#
#.....###....##.....#
#####################
