####################
#.....##....##.....#
#..................#
#.....##....##.....#
#########..#########
        #..#
        #..#
        #..#
        #..#
#########..#########
#.....##....##.....#
#..................#
#.....##....##.....#
####################
