#####################################
#...................................#
#...................................#
#...................................#
#...................................#
#...................................#
#...................................#
#...................................#
#...................................#
#...................................#
#.....#################.............#
#.....#               #.............#
#.....#               #.............#
#.....#               #.............#
#.....#               #.............#
#.....#               #.............#
#.....#               #.............#
#.....#               #.............#
#.....#               #.............#
#.....#################.............#
#...................................#
#...................................#
#...................................#
#...................................#
#...................................#
#...................................#
#...................................#
#...................................#
#...................................#
#...................................#
#...................................#
#...................................#
#...................................#
#...................................#
#####################################
