################################################################################
#..............................................................................#
#..............................................................................#
#..............................................................................#
#..............................................................................#
#..............................................................................#
#..............................................................................#
#..............................................................................#
#..............................................................................#
#..............................................................................#
#.....#################........................................................#
#.....#...............#........................................................#
#.....#...............#........................................................#
#.....#...............#........................................................#
#.....#...............#........................................................#
#.....#...............#........................................................#
#.....#...............#........................................................#
#.....#...............#........................................................#
#.....#...............#........................................................#
#.....#################........................................................#
#..............................................................................#
#..............................................................................#
#..............................................................................#
#..............................................................................#
#..............................................................................#
#..............................................................................#
#..............................................................................#
#..............................................................................#
#..............................................................................#
#..............................................................................#
#..............................................................................#
#..............................................................................#
#..............................................................................#
#..............................................................................#
#..............................................................................#
#..............................................................................#
#..............................................................................#
#..............................................................................#
#..............................................................................#
################################################################################
